................................^####....
....................................#....
....................................#....
....................................#....
....................................#....
....................................#....
....................................#....
....................................#....
....................................#....
....................................#....
....................................#....
....................................#....
..........................###########....
..........................#..............
..........................#..............
..........................#..............
................#############............
..........................#.#............
..............#####.......#.#............
..............#...#.......#.#............
..............#...#.......#.#............
..............#...#.......#.#............
..............#...#.......#.#.###########
..............#...#.......#.#.#.........#
..............#...#.......#############.#
..............#...#.........#.#.......#.#
..............#...#.........#############
..............#...#...........#.......#..
..........#############...#############..
..........#...#...#...#...#...#..........
..#############...#############..........
..#.......#...........#...#..............
..#.......#...........#...#..............
..#.......#...........#...#..............
..#############.......#...#..............
..........#...#.......#...#..............
###########...#.......#...#..............
#.............#.......#...#..............
#.............#.......#...#..............
#.............#.......#...#..............
#.............#.......#####..............
#.............#..........................
#.............#..........................
#.............#..........................
#.............#..........................
#.............#..........................
#...###########..........................
#...#....................................
#########................................
....#...#................................
....#...#................................
....#...#................................
....#...#................................
....#...#................................
....#...#................................
....#...#................................
....#...#................................
....#...#................................
....#####................................